1111111111111111111111111111111111111111111111111111111111
100000000000000000000000000C0C00000000000000000000000000E1
1011111111111111111111111110001111111111111111111111111101
1000000000000000000000000000000000000000000000000000000001
101111111111111111111111111C0C1111111111111111111111111101
101C00000000000000000000000000000000000000000000000000C101
101C00000000000000000000000000000000000000000000000000C101
101111111111111111111111111C0C1111111111111111111111111101
1000000000000000000000000000000000000000000000000000000001
1000000000000000000000000000000000000000000000000000000001
1000000000000000000000000000000000000000000000000000000001
1000000000000000000000000000000000000000000000000000000001
1000000000000000000000000000000000000000000000000000000001
1000000000000000000000000000000000000000000000000000000001
1000000000000000000000000000000000000000000000000000000001
1000000000000000000000000000000000000000000000000000000001
1000000000000000000000000000000000000000000000000000000001
1000000000000000000000000000000000000000000000000000000001
1000000000000000000000000000000000000000000000000000000001
1000000000000000000000000000000000000000000000000000000001
1000000000000000000000000000000000000000000000000000000001
1000000000000000000000000000000000000000000000000000000001
101111111111111111111111111C0C1111111111111111111111111101
101C00000000000000000000000000000000000000000000000000C101
101C00000000000000000000000000000000000000000000000000C101
101111111111111111111111111C0C1111111111111111111111111101
1000000000000000000000000000000000000000000000000000000001
1011111111111111111111111110001111111111111111111111111101
1P0000000000000000000000000C0C0000000000000000000000000001
1111111111111111111111111111111111111111111111111111111111