111111
100001
100001
1PE001
100001
100001
111111