1111111111111111111111
1010001011101110101111
1010101111111111111011
1000000000000000001111
1011101011110010111011
1111111C11101010001011
1000111011111010111011
1010101011111110101011
1110111010001010111101
1000C00010101000P001E1
1111111111111111111111