111111
1000E1
100C01
10E001
100001
10P001
111111