11111111111111111111111111111111
1010001011101110101000000000111
101010111111111111101111111111
10000000000000000000000001111
1011101011110010111000001111
1111111C1110101000100001111
10001110111110101110001111
1010101011111110101001111
111011101000101011110111
1000C00010101000P001E11
1111111111111111111111