111111
1P1C01
101101
10C001
110101
1C10E1
111111