111111
100001
100C01
10E001
100001
10P0P1
111111