111111
100001
100C01
10E001
100001
100001
111111