110111
10C001
100001
1PEC01
100001
1C0001
111111