111111
100001
100C01
10P001
100001
100001
111111