111111
1CCCC1
1CCCC1
1PECC1
10CCC1
111111