111111111111111
1C00000000000E1
101011111111101
101000000000101
101011111110101
1010000C1C00101
101011111110101
100000000000101
101110101110101
101C00101C00101
101011101111101
101C00100000001
101110111111101
1P00000000000C1
111111111111111