111111
10C001
100001
100E01
100001
1C00P1
111111